1 1 0 0 6 6 0 0 2 2 6 0 0 2 0
0 3 3 0 0 2 2 0 0 5 2 2 0 0 0
2 2 0 0 4 4 0 0 1 1 4 0 0 1 0
0 4 4 0 0 3 3 0 0 5 3 3 0 0 0
5 5 6 6 1 1 2 2 3 3 1 2 2 3 0
4 4 3 3 5 5 6 6 1 1 5 6 6 1 0
0 0 0 0 0 0 0 0 0 0 0 0 0 0 0
0 0 0 0 0 0 0 0 0 0 0 0 0 0 0 
0 0 0 0 0 0 0 0 0 0 0 0 0 0 0
0 0 0 0 0 0 0 0 0 0 0 0 0 0 0
0 0 0 0 0 0 0 0 0 0 0 0 0 0 0
0 0 0 0 0 0 0 0 0 0 0 0 0 0 0
0 0 0 0 0 0 0 0 0 0 0 0 0 0 0
0 0 0 0 0 0 0 0 0 0 0 0 0 0 0
0 0 0 0 0 0 0 0 0 0 0 0 0 0 0