1 2 3 4 5 5 4 3 2 1 5 4 3 2 0
0 6 5 4 3 2 3 4 5 6 2 3 4 5 0
0 1 2 3 4 4 3 2 1 0 4 3 2 1 0
0 0 6 5 2 1 2 5 6 0 1 2 5 6 0
0 0 2 3 4 4 3 2 0 0 4 3 2 0 0
0 0 0 3 2 1 2 3 0 0 1 2 3 0 0
0 0 0 5 4 4 5 0 0 0 4 5 0 0 0
0 0 0 0 6 1 6 0 0 0 1 6 0 0 0
0 0 0 0 2 2 0 0 0 0 2 0 0 0 0
0 0 0 0 0 3 0 0 0 0 3 0 0 0 0
0 0 0 0 0 0 0 0 0 0 0 0 0 0 0
0 0 0 0 0 0 0 0 0 0 0 0 0 0 0
0 0 0 0 0 0 0 0 0 0 0 0 0 0 0
0 0 0 0 0 0 0 0 0 0 0 0 0 0 0
0 0 0 0 0 0 0 0 0 0 0 0 0 0 0